6 9
##S...##.
...##.#..
.#..#.#.#
.##.#...#
..#.##.##
#F.......